1111111111
100P00C0E0
1111111111