11111111111111111111
10000000000000000001
100000C00000E00000P1
10000000000000000001
100000001000C0000001
100000000000000000C1
1C000000000000C00001
100C0000000000000101
10010000000000000011
10000C00000000000001
10000000100000000001
10000000000000000001
10000000C00000000011
10000010010000000001
10000000000000001001
100CC000100000000001
10000000000000000001
10000000000000000001
10000000000000000001
11111111111111111111