11111111111111111111
10000000000001001001
10010000000000000011
10000000000000010001
11101001010000P10001
11000C10000000C00101
10C00010000000000001
10000000000000001101
110010000000C0000001
10001100000000000001
10000010000000000001
111000C0000000000001
10010000000000010001
11C01000000000100101
10C00000000000000101
10E10000000000000001
10110000001011000001
10CC0000001000000001
10000000C10000001001
11111111111111111111